20 9 12

0: 0 0 0 0 0 0 1 1 0 0 0 0 0 0 0 1 0 1 1 0
1: 0 1 0 1 0 0 0 0 0 0 0 0 0 0 1 1 1 0 0 0
2: 0 0 0 0 0 1 1 0 0 0 1 0 0 1 0 1 0 0 0 0
3: 0 0 0 0 0 0 0 0 1 0 0 1 0 0 0 1 0 1 1 0
4: 0 1 0 0 1 0 0 1 0 1 0 0 0 0 0 0 1 0 0 0
5: 1 1 0 0 0 0 0 0 0 0 0 1 0 1 0 0 0 0 1 0
6: 0 0 1 0 0 1 0 0 0 0 0 0 1 1 0 0 0 0 1 0
7: 0 0 1 0 0 0 1 0 1 0 0 0 1 0 0 0 1 0 0 0
8: 0 0 1 0 0 0 0 1 0 0 0 0 0 0 0 1 0 1 0 1

0: 0 1 2 1 2 2 1 2 1 2 2 1 2 1 1 1 2 2 1 2
1: 1 0 1 1 1 2 1 1 1 1 1 1 2 1 2 1 1 1 1 2
2: 2 1 0 1 1 2 2 1 1 1 1 1 1 1 1 1 2 2 1 1
3: 1 1 1 0 1 1 2 2 1 1 2 2 2 2 2 2 1 2 2 1
4: 2 1 1 1 0 1 2 2 2 2 2 1 1 1 2 2 1 1 2 2
5: 2 2 2 1 1 0 2 2 2 1 1 1 2 1 2 1 2 2 1 2
6: 1 1 2 2 2 2 0 1 1 1 1 2 1 2 1 2 1 1 2 2
7: 2 1 1 2 2 2 1 0 1 2 1 1 1 1 1 2 2 2 1 1
8: 1 1 1 1 2 2 1 1 0 2 1 1 2 1 1 2 1 2 1 2
9: 2 1 1 1 2 1 1 2 2 0 2 2 1 1 1 2 2 2 2 1
10: 2 1 1 2 2 1 1 1 1 2 0 1 2 2 2 2 2 1 1 2
11: 1 1 1 2 1 1 2 1 1 2 1 0 1 2 1 1 2 1 2 1
12: 2 2 1 2 1 2 1 1 2 1 2 1 0 1 2 2 2 2 1 2
13: 1 1 1 2 1 1 2 1 1 1 2 2 1 0 1 1 2 2 2 1
14: 1 2 1 2 2 2 1 1 1 1 2 1 2 1 0 2 1 1 2 1
15: 1 1 1 2 2 1 2 2 2 2 2 1 2 1 2 0 2 1 2 2
16: 2 1 2 1 1 2 1 2 1 2 2 2 2 2 1 2 0 1 1 2
17: 2 1 2 2 1 2 1 2 2 2 1 1 2 2 1 1 1 0 2 2
18: 1 1 1 2 2 1 2 1 1 2 1 2 1 2 2 2 1 2 0 1
19: 2 2 1 1 2 2 2 1 2 1 2 1 2 1 1 2 2 2 1 0


